1111111111111111111111111111111111
1000000000000000000001110000000001
1001111110111101010101110111011101
1001000000111101010100000111000001
1001000000111101010101110111011101
10E10000000000010101011100E0011101
1001111111101101010101111101111101
1000011111101100000001111101111101
1001011111101111011100000000000001
1001000000000000011101111101100101
1001011011101111011101111101100101
1001011011101111000000000001100101
1000000011101111010101111101100101
1011111011101111010101111101100101
1011111011100000010101111101100001
1011111011101111010101100000000101
1011111011101111010101101111100101
1000000000001111010101101111100101
1011111011101111010101101111100101
1011111011101111010101101111100101
1011111011100000000000000000000001
1011111011111011000001111011011001
1011000000011011111111111011011001
1011001110011010000000001011011011
1000001110000010110011101011011011
1011000000011010000000001011000011
1011111011111010110011101011111011
1011111011111010000000001011111011
1011111011111011110011111000000001
1000000000000011110011111011111001
1000000000000011110011111011111001
1111011011011000000000000000000001
111101101101100000P000000000000001
1111011011011011111011110111111101
1000011011000011111011110111111101
1011111011110111111011110000111101
1011111011110111100000110110111101
1000000000000000001110110110001101
1011111011110111101110000111101101
1011111011110111100000110111100001
1000011011000111101110110111111101
1011011011011100001110110111111101
1011011011000001100000000000000001
1011011011011011101111011110111101
1011000000011011101111011110111101
1011111011010000000011011110111101
1011111011000111011011000000000001
1000000000000111011011011111111101
1011111111010000000000000000000001
1011111111010101010101011101111101
1011100000010101010101010001000101
1011101111010101010101010101010101
1000001111E101010101E1010101010101
1011111111010101010101010101010101
1011100000000000000000010100000101
1011101111011111110111010111110101
1000001111000000000000000000000001
1111111111111111111111111111111111