1111111111111111111111111111111111
1000000000000000000000000000000001
1011111110111110101011101111111101
1000111110111100000011101111111101
1010011110111100000011100000000001
1011001110111101001011110111101001
1011100000001101001011110111101001
1011110111101101001011110111101001
1011110111000001001000000011101001
1011110111011101001011111011101001
1011110111001101001011111011101001
1000000111101101001011111011101001
1011101111101100000011111000001001
1011100000001111001111111101101001
1011111011101111001111111101101001
1011111011101000000001111101101001
1011111011101000000001111101100001
1011111011101001111001111101111101
1000000000000001111000000000000001
1000000000000001111000000010111101
1110111011111001111001101000111101
1110111011111000000001101110111101
1110111011111000000001000010000101
1000000000001111001111011011110101
1110111011101111001100011000000001
1110111011101111001101111110110101
1110111011101111001101110000110101
1110000000000000001101110111110101
1110111011101011001101110111110101
1110111011101011001101110111110101
1000011011101011001101110111110101
1011000000000000000000000111100001
1011000000000111001101110111101101
1011011111110111001101110111100001
1001000000000111001101110111101111
1001001110000111001101100001101111
1001000000000111001101101100001111
1001011110000000001101101101111111
1000000010010111000000001101111111
1001011010010111001101100000000001
1001011010010111001101101101111101
1001001010010111001101101101110001
1001101010010111001100000001110101
1001101010010111001101101101110101
1011100010010111001101101100000001
1011111010010111001101111101111101
1011111010010111001101111101000101
1010000000000000000000000000010101
1010101010010101010101011011010101
1010101010010101010101011011010101
1000101010010101010101011011000101
1011101010010101010101011011010101
1000001010010101010101011011010101
1011111010010000000000011011010101
1011111010010111111111011011000001
1000000010010111111111000011111101
1000000000000000000000000000000001
1111111111111111111111111111111111