1111111111111111111111111111111111
1111111111111100000000000000000001
1100000000000101E1E101111110111101
1101111011110101010101111110111101
1101000000010101010100000000000101
1101011011010101010101110110110101
1101010001010101010101110110110101
1101010001010100000000000000000001
1101010101010101011011011111110101
1101010101010101011011010000000101
1100010101000001011011010111110101
1101010101010101011011010100000101
1101010001010100000000000101110101
1101010001010101011011010100000101
1101011011010101011011010111110101
1101000000010101011011010000000101
1101111111110101011011011111110101
1100000000000100000000000000000001
1111111011111101011011011011110101
1000000000000001011011011011110101
1101011011110111011000000000000101
1101011011110111011111011110110101
1101011011110111011111011110110101
1101011011110111011111011110110101
1001000000000000000000011110110101
1001011101111011111100000000000001
1001011101100000100000000000000001
1001000001101110101111011101111101
1001011101101110101111011101111101
1001011101101110001111011101111101
1000000000000000001110001101100001
1001011100111110001110101101101101
1001011100111110001110101101101101
1001010000001110000000000000001101
1000010000001110P01110101101101101
1001010011001110001110101101101101
1001010011001110001110001101100001
1001010000000000001111011101111101
1001011111110110001111011101111101
1000000000000110001111000000000001
1011011011010110001111011111111101
1011011011010000000000011000000001
1000000000000111011011011011101101
1011011011010111000011000000001101
1011011011010111011111011111111101
1000000000010000000000000000000001
1011011011010111011101111101110111
1011011011010111011101111101110111
1000000000000000000000011101110111
1111011110110101010101000000000001
1111011110010101010101011101111101
1111011111010101010101000000000001
1000000011010101010101011111101101
1011011011E1E1E1E1E1E1010000001101
1011011000000000000000010111101101
1011011011011111011111010111101101
1000000000000000000000000111100001
1111111111111111111111111111111111