1111111111111111111111111111111111
1000000000000000111111110000000001
1011101111101100000011110111111101
1011101111101100010011110000000001
1000000000000000010000000111011101
10111111E1111100000011110111E11101
1000000000000000111011110000000001
1000011111101011111011110111111101
1101000000101011100000000000000001
1101011110101011101110111111111011
1101010000101011101110100000001011
1101010110101000001110100000001011
1001010110101011101110101111101011
1011010000101011101110101111101011
1011010111101000000000100000001011
1000010000001011101100111001111011
1011010111111011101100111001111011
1011000000000011101100111001111001
1011111111111011100000000000000001
1000000110000000000000000001110111
1011110110111111100111111001110111
1011110000000011100111111000000111
1011110110111011100000011001110011
1000000110111000000110011001110011
1101111110111111100110011001111011
1100000000000000000110000000000011
1101111110111111100111111001111011
1101111110111111100111111001111011
11000000000000000P0000000000000001
1101110110111101100111011001111011
1101110110111101100111011001111011
1101110110110000000000011001100011
1101110110110101100111011001101011
1100000000000001100111000001101011
1101101110111101100000011000001001
1101101110111101100111011001111101
1100000000001101100111011001111101
1101111011100000000000000000000001
1001111011100000000000000000000001
1000000000111011011101111001101101
1001101110111011011101111001101101
1001101110111000000001111001101101
1000101110111011011100000001100001
1001100000000011000001011001101101
1001101111101111011101011001101101
1001101111101111011101011001101101
1000000000000000000001000000001101
1110111011011111011101011001101101
1110111011011111011101011001101101
1110000000000000000000011001101101
1110111011010101010101011001101101
1110111011010101010101011000000001
1000011000010101010101000001111101
1011000011010101010101011001111101
1011011111010101010101011000001101
1011011111E1E1E1E1E1E1E11001101101
1000000000000000000000000001100001
1111111111111111111111111111111111